############
#         O#
# P     ####
#          #
#######    #
# O  ##    #
#    ##    #
#          #
# XX       #
#        # #
############
